........................................
........................................
............X....X.X.X..................
..........X.............................
.........X.X............................
........X...............................
.............X..........................
......X.......X.........................
.............X..........................
........X.S.X...........................
.........X.X............................
......X...X....................X........
............X....X.X.X..................
...X..X..X..X....X..X.......X..X..X.....
............XXXXXXXXXXXX................
......X..........X.............X........
........................................
.....XXXXXXXXXXXXXXXXXXXXXXXXXXXXXX.....
............X...........................
....X.......X......X....................
............XXX.........................
.X..X..X........X..X..X.................
........................................
....X..............X....................
............XXXXX.......................
............X...X.......................
................X.......................
............X.X.X.......................
............X.D.X.......................
............X...........................
............XXXXX.......................
........................................
........................................
........................................
........................................
........................................
........................................
........................................
........................................
........................................
........................................
........................................
........................................
........................................
........................................
........................................
........................................
........................................
........................................
........................................
........................................
........................................
